+--------------------------------+
|              LOGO              |
+-------------------+------------+
|                   |            |
|                   |            |
|                   |            |
|       VIDEO       |   TEXTO    |
|                   |            |
|                   |            |
|                   |            |
+--------------------------------+
|            SPONSORS            |
+--------------------------------+
